20 40
2231233232211121233233321311112223211221
3233331221221332322311321211322222312333
3322221211212331322232131331112331321131
3223121322333111312333113333212233222233
3111333111111233231121213132332331322113
2132312322121331113331331132131213312111
3221231211331112113122111222111211233213
2312312313333212333211213123111222212212
2113123113313112323223211222313131232121
2123213212131132321111232233331121213333
3123231132131123331223333213332131313313
1313232223223311121323333212311322112211
1233332123112221122222313311132312313233
1222221121332331122323333112312211122312
2112333122332322322333321233331331111323
1232132113313132121221321223331212232122
2133321313111133313323332112221322322223
1222232312112313111231122221132122332313
3131332132111133313122232132331223322313
3233331211332322323222322323122311133131
